"Date","RPU","RPU exploitables","Hospitalisations","Mutations","Transferts","Taux hospitalisation"
2014-01-01,972,868,194,179,15,22.35
2014-01-02,1055,877,265,243,22,30.22
2014-01-03,1038,867,264,241,23,30.45
2014-01-04,982,824,237,221,16,28.76
2014-01-05,918,822,184,171,13,22.38
2014-01-06,1000,860,242,227,15,28.14
2014-01-07,994,857,231,212,19,26.95
2014-01-08,965,859,228,211,17,26.54
2014-01-09,964,847,225,204,21,26.56
2014-01-10,903,770,222,205,17,28.83
2014-01-11,973,789,199,182,17,25.22
2014-01-12,837,728,162,155,7,22.25
2014-01-13,1030,885,215,205,10,24.29
2014-01-14,890,772,220,205,15,28.5
2014-01-15,840,785,253,236,17,32.23
2014-01-16,958,812,244,231,13,30.05
2014-01-17,885,739,238,231,7,32.21
2014-01-18,964,825,228,209,19,27.64
2014-01-19,929,806,182,174,8,22.58
2014-01-20,977,835,217,209,8,25.99
2014-01-21,871,742,225,207,18,30.32
2014-01-22,922,802,224,212,12,27.93
2014-01-23,913,807,216,208,8,26.77
2014-01-24,882,760,229,214,15,30.13
2014-01-25,936,797,189,180,9,23.71
2014-01-26,899,778,192,178,14,24.68
2014-01-27,1012,847,227,215,12,26.8
2014-01-28,957,814,218,203,15,26.78
2014-01-29,904,784,227,222,5,28.95
2014-01-30,931,798,204,191,13,25.56
2014-01-31,936,787,232,225,7,29.48
2014-02-01,1049,880,220,201,19,25
2014-02-02,1048,870,191,179,12,21.95
2014-02-03,1193,1008,255,236,19,25.3
2014-02-04,1030,884,235,211,24,26.58
2014-02-05,989,871,193,182,11,22.16
2014-02-06,1109,1001,271,244,27,27.07
2014-02-07,933,851,223,215,8,26.2
2014-02-08,1131,994,225,213,12,22.64
2014-02-09,1094,994,213,207,6,21.43
2014-02-10,1203,1027,269,245,24,26.19
2014-02-11,1055,901,228,207,21,25.31
2014-02-12,1024,927,273,255,18,29.45
2014-02-13,1071,986,294,263,31,29.82
2014-02-14,1043,918,262,235,27,28.54
2014-02-15,1067,931,244,230,14,26.21
2014-02-16,1108,1006,183,168,15,18.19
2014-02-17,1272,1151,274,258,16,23.81
2014-02-18,1083,965,266,249,17,27.56
2014-02-19,1026,948,253,234,19,26.69
2014-02-20,1066,969,241,224,17,24.87
2014-02-21,1042,926,254,236,18,27.43
2014-02-22,982,884,229,217,12,25.9
2014-02-23,1056,940,220,201,19,23.4
2014-02-24,1163,982,312,263,49,31.77
2014-02-25,995,859,227,213,14,26.43
2014-02-26,955,811,218,206,12,26.88
2014-02-27,974,829,225,205,20,27.14
2014-02-28,1038,918,261,243,18,28.43
2014-03-01,1080,964,235,217,18,24.38
2014-03-02,1024,913,199,184,15,21.8
2014-03-03,1156,1032,268,249,19,25.97
2014-03-04,1038,901,240,219,21,26.64
2014-03-05,846,761,185,170,15,24.31
2014-03-06,827,729,187,180,7,25.65
2014-03-07,843,745,217,194,23,29.13
2014-03-08,1014,901,227,211,16,25.19
2014-03-09,1193,1057,216,201,15,20.44
2014-03-10,1138,1020,288,269,19,28.24
2014-03-11,1033,897,230,214,16,25.64
2014-03-12,1058,946,241,228,13,25.48
2014-03-13,1003,860,229,213,16,26.63
2014-03-14,1069,927,239,215,24,25.78
2014-03-15,1103,997,228,212,16,22.87
2014-03-16,1154,1034,201,183,18,19.44
2014-03-17,990,844,220,198,22,26.07
2014-03-18,768,721,210,190,20,29.13
2014-03-19,995,833,203,187,16,24.37
2014-03-20,1119,961,241,228,13,25.08
2014-03-21,1141,977,262,236,26,26.82
2014-03-22,1059,949,205,191,14,21.6
2014-03-23,1103,981,211,200,11,21.51
2014-03-24,1220,1055,264,245,19,25.02
2014-03-25,1042,907,226,213,13,24.92
2014-03-26,993,883,254,236,18,28.77
2014-03-27,981,838,229,210,19,27.33
2014-03-28,981,864,252,231,21,29.17
2014-03-29,1054,906,214,192,22,23.62
2014-03-30,1225,1080,209,194,15,19.35
2014-03-31,1177,1039,256,230,26,24.64
2014-04-01,1064,912,237,218,19,25.99
2014-04-02,1119,962,236,215,21,24.53
2014-04-03,1121,977,234,220,14,23.95
2014-04-04,1174,1016,265,244,21,26.08
2014-04-05,1142,1025,229,211,18,22.34
2014-04-06,1242,1071,207,191,16,19.33
2014-04-07,1292,1126,255,242,13,22.65
2014-04-08,1071,893,219,200,19,24.52
2014-04-09,1041,921,211,193,18,22.91
2014-04-10,1133,948,225,206,19,23.73
2014-04-11,1175,984,267,240,27,27.13
2014-04-12,1254,1092,247,226,21,22.62
2014-04-13,1248,1088,227,211,16,20.86
2014-04-14,1311,1155,268,246,22,23.2
2014-04-15,1066,918,234,222,12,25.49
2014-04-16,1104,951,267,246,21,28.08
2014-04-17,1130,998,230,215,15,23.05
2014-04-18,1050,926,206,191,15,22.25
2014-04-19,1159,1023,211,198,13,20.63
2014-04-20,1070,937,222,207,15,23.69
2014-04-21,1079,949,200,187,13,21.07
2014-04-22,1165,973,256,244,12,26.31
2014-04-23,1018,879,225,213,12,25.6
2014-04-24,903,762,211,193,18,27.69
2014-04-25,1091,949,259,240,19,27.29
2014-04-26,1146,991,234,217,17,23.61
2014-04-27,1061,932,187,174,13,20.06
2014-04-28,972,847,246,233,13,29.04
2014-04-29,908,785,208,190,18,26.5
2014-04-30,944,799,210,189,21,26.28
2014-05-01,940,817,193,173,20,23.62
2014-05-02,1125,953,249,225,24,26.13
2014-05-03,1043,951,209,195,14,21.98
2014-05-04,1020,911,204,186,18,22.39
2014-05-05,1195,1008,268,254,14,26.59
2014-05-06,984,843,228,220,8,27.05
2014-05-07,982,839,209,193,16,24.91
2014-05-08,1024,926,207,190,17,22.35
2014-05-09,937,808,221,197,24,27.35
2014-05-10,964,861,202,186,16,23.46
2014-05-11,1049,930,196,183,13,21.08
2014-05-12,1166,1010,263,248,15,26.04
2014-05-13,922,756,222,204,18,29.37
2014-05-14,1023,851,216,194,22,25.38
2014-05-15,985,848,235,220,15,27.71
2014-05-16,1014,806,189,167,22,23.45
2014-05-17,1055,862,200,188,12,23.2
2014-05-18,1143,997,216,204,12,21.66
2014-05-19,1245,1057,265,250,15,25.07
2014-05-20,1068,893,263,243,20,29.45
2014-05-21,1111,969,229,220,9,23.63
2014-05-22,928,809,226,194,32,27.94
2014-05-23,1134,957,256,242,14,26.75
2014-05-24,1196,997,218,203,15,21.87
2014-05-25,1265,1096,233,217,16,21.26
2014-05-26,1226,1056,248,235,13,23.48
2014-05-27,995,852,212,194,18,24.88
2014-05-28,1192,942,217,206,11,23.04
2014-05-29,1126,934,204,188,16,21.84
2014-05-30,1337,1094,268,252,16,24.5
2014-05-31,1236,1044,229,212,17,21.93
2014-06-01,1179,1006,192,174,18,19.09
2014-06-02,1159,1005,251,226,25,24.98
2014-06-03,1116,928,229,212,17,24.68
2014-06-04,1007,852,218,203,15,25.59
2014-06-05,1126,1000,258,242,16,25.8
2014-06-06,1138,909,241,214,27,26.51
2014-06-07,1240,1047,221,199,22,21.11
2014-06-08,1246,1041,202,189,13,19.4
2014-06-09,1259,1119,206,197,9,18.41
2014-06-10,1269,1074,281,259,22,26.16
2014-06-11,1164,993,221,204,17,22.26
2014-06-12,1213,1020,250,232,18,24.51
2014-06-13,1063,890,212,188,24,23.82
2014-06-14,1030,892,201,187,14,22.53
2014-06-15,1264,1064,197,179,18,18.52
2014-06-16,1313,1113,250,230,20,22.46
2014-06-17,1156,964,237,221,16,24.59
2014-06-18,1151,994,236,213,23,23.74
2014-06-19,1079,919,214,200,14,23.29
2014-06-20,1164,997,265,246,19,26.58
2014-06-21,1218,1042,216,199,17,20.73
2014-06-22,1290,1146,230,214,16,20.07
2014-06-23,1329,1128,249,231,18,22.07
2014-06-24,1133,949,225,205,20,23.71
2014-06-25,1142,986,244,221,23,24.75
2014-06-26,1107,930,235,217,18,25.27
2014-06-27,1128,917,234,216,18,25.52
2014-06-28,1168,1022,254,238,16,24.85
2014-06-29,1208,1061,244,221,23,23
2014-06-30,1236,1047,253,235,18,24.16
2014-07-01,985,842,208,191,17,24.7
2014-07-02,1092,901,227,209,18,25.19
2014-07-03,1041,897,233,219,14,25.98
2014-07-04,1114,936,200,185,15,21.37
2014-07-05,1216,985,205,192,13,20.81
2014-07-06,1324,1102,187,164,23,16.97
2014-07-07,1233,1021,260,243,17,25.47
2014-07-08,1059,862,222,208,14,25.75
2014-07-09,1020,856,212,195,17,24.77
2014-07-10,890,749,219,202,17,29.24
2014-07-11,1136,934,236,224,12,25.27
2014-07-12,1152,976,215,197,18,22.03
2014-07-13,1224,1048,201,184,17,19.18
2014-07-14,1250,1060,206,191,15,19.43
2014-07-15,1086,917,217,206,11,23.66
2014-07-16,1162,969,227,211,16,23.43
2014-07-17,1080,920,224,210,14,24.35
2014-07-18,1183,940,224,208,16,23.83
2014-07-19,1185,957,197,188,9,20.59
2014-07-20,1213,1024,187,174,13,18.26
2014-07-21,1213,1022,250,233,17,24.46
2014-07-22,1155,969,246,232,14,25.39
2014-07-23,1128,975,263,251,12,26.97
2014-07-24,1119,944,218,206,12,23.09
2014-07-25,1109,931,225,213,12,24.17
2014-07-26,1190,1013,247,222,25,24.38
2014-07-27,1116,950,226,209,17,23.79
2014-07-28,1198,1025,257,241,16,25.07
2014-07-29,908,814,214,207,7,26.29
2014-07-30,978,858,228,214,14,26.57
2014-07-31,1013,862,238,219,19,27.61
2014-08-01,1021,845,237,224,13,28.05
2014-08-02,936,830,191,177,14,23.01
2014-08-03,1068,875,176,162,14,20.11
2014-08-04,1075,919,234,215,19,25.46
2014-08-05,1063,889,237,215,22,26.66
2014-08-06,1011,882,228,210,18,25.85
2014-08-07,1033,883,238,220,18,26.95
2014-08-08,1038,856,229,207,22,26.75
2014-08-09,1110,929,200,180,20,21.53
2014-08-10,1069,897,177,163,14,19.73
2014-08-11,1150,977,268,258,10,27.43
2014-08-12,1091,892,238,214,24,26.68
2014-08-13,1006,857,245,227,18,28.59
2014-08-14,988,823,225,207,18,27.34
2014-08-15,926,783,167,161,6,21.33
2014-08-16,1149,961,213,199,14,22.16
2014-08-17,1058,893,190,172,18,21.28
2014-08-18,1203,1022,255,236,19,24.95
2014-08-19,996,767,197,182,15,25.68
2014-08-20,957,795,230,218,12,28.93
2014-08-21,1003,793,206,193,13,25.98
2014-08-22,999,808,214,199,15,26.49
2014-08-23,1058,886,211,194,17,23.81
2014-08-24,1064,903,190,169,21,21.04
2014-08-25,1118,913,239,213,26,26.18
2014-08-26,982,811,191,177,14,23.55
2014-08-27,1057,886,241,225,16,27.2
2014-08-28,1042,891,243,222,21,27.27
2014-08-29,1098,914,231,209,22,25.27
2014-08-30,1146,942,201,186,15,21.34
2014-08-31,1048,895,177,159,18,19.78
2014-09-01,990,826,231,220,11,27.97
2014-09-02,899,757,211,198,13,27.87
2014-09-03,999,859,207,197,10,24.1
2014-09-04,1036,871,226,215,11,25.95
2014-09-05,1062,883,245,227,18,27.75
2014-09-06,1202,971,237,215,22,24.41
2014-09-07,1278,1081,206,199,7,19.06
2014-09-08,1253,1067,270,257,13,25.3
2014-09-09,1117,920,249,236,13,27.07
2014-09-10,1055,897,202,189,13,22.52
2014-09-11,1010,908,233,219,14,25.66
2014-09-12,1097,897,238,227,11,26.53
2014-09-13,1167,945,226,199,27,23.92
2014-09-14,1234,1034,192,181,11,18.57
2014-09-15,1202,1022,241,223,18,23.58
2014-09-16,1081,945,242,228,14,25.61
2014-09-17,1143,990,240,221,19,24.24
2014-09-18,1126,953,209,199,10,21.93
2014-09-19,1138,980,256,241,15,26.12
2014-09-20,1195,1023,240,226,14,23.46
2014-09-21,1088,937,193,181,12,20.6
2014-09-22,1154,1013,244,230,14,24.09
2014-09-23,1030,893,280,256,24,31.35
2014-09-24,1098,913,227,211,16,24.86
2014-09-25,1075,961,260,246,14,27.06
2014-09-26,1170,965,254,237,17,26.32
2014-09-27,1285,1038,220,203,17,21.19
2014-09-28,1300,1046,187,176,11,17.88
2014-09-29,1250,1063,244,227,17,22.95
2014-09-30,1203,985,227,213,14,23.05
2014-10-01,1183,950,219,206,13,23.05
2014-10-02,1287,1032,250,226,24,24.22
2014-10-03,1253,1019,252,234,18,24.73
2014-10-04,1280,1051,245,223,22,23.31
2014-10-05,1271,1050,205,197,8,19.52
2014-10-06,1300,1072,249,238,11,23.23
2014-10-07,1345,967,293,277,16,30.3
2014-10-08,1407,966,269,256,13,27.85
2014-10-09,1413,1048,341,321,20,32.54
2014-10-10,1509,1035,310,289,21,29.95
2014-10-11,1444,1043,283,262,21,27.13
2014-10-12,1608,1116,258,242,16,23.12
2014-10-13,1689,1176,339,318,21,28.83
2014-10-14,1495,1013,284,268,16,28.04
2014-10-15,1176,835,217,191,26,25.99
2014-10-16,1373,946,218,206,12,23.04
2014-10-17,1401,983,242,222,20,24.62
2014-10-18,1503,1060,209,199,10,19.72
2014-10-19,1521,990,208,185,23,21.01
2014-10-20,1514,1073,240,225,15,22.37
2014-10-21,1212,852,212,199,13,24.88
2014-10-22,1152,801,213,199,14,26.59
2014-10-23,1248,867,209,192,17,24.11
2014-10-24,1164,853,219,207,12,25.67
2014-10-25,1256,885,187,177,10,21.13
2014-10-26,1324,930,180,166,14,19.35
2014-10-27,1317,960,237,227,10,24.69
2014-10-28,937,713,180,158,22,25.25
2014-10-29,1049,764,216,198,18,28.27
2014-10-30,1109,785,214,200,14,27.26
2014-10-31,1200,837,207,190,17,24.73
2014-11-01,1395,904,201,180,21,22.23
2014-11-02,1369,935,194,181,13,20.75
2014-11-03,1462,1040,251,232,19,24.13
2014-11-04,1260,881,218,202,16,24.74
2014-11-05,1215,871,219,201,18,25.14
2014-11-06,1330,947,219,208,11,23.13
2014-11-07,1257,982,270,247,23,27.49
2014-11-08,1370,978,235,215,20,24.03
2014-11-09,1373,935,201,176,25,21.5
2014-11-10,1470,1025,216,198,18,21.07
2014-11-11,1233,843,188,177,11,22.3
2014-11-12,1381,940,211,199,12,22.45
2014-11-13,1296,929,222,206,16,23.9
2014-11-14,1332,1013,303,285,18,29.91
2014-11-15,1419,1000,259,239,20,25.9
2014-11-16,1342,938,187,174,13,19.94
2014-11-17,1347,938,223,206,17,23.77
2014-11-18,1310,941,214,202,12,22.74
2014-11-19,1325,935,254,234,20,27.17
2014-11-20,1367,922,207,199,8,22.45
2014-11-21,1319,910,209,186,23,22.97
2014-11-22,1385,962,219,194,25,22.77
2014-11-23,1503,1032,189,174,15,18.31
2014-11-24,1309,913,199,179,20,21.8
2014-11-25,1250,862,220,198,22,25.52
2014-11-26,1268,884,207,196,11,23.42
2014-11-27,1307,935,234,210,24,25.03
2014-11-28,1298,910,219,201,18,24.07
2014-11-29,1336,890,214,192,22,24.04
2014-11-30,1410,949,199,185,14,20.97
2014-12-01,1416,984,230,213,17,23.37
2014-12-02,1255,851,208,189,19,24.44
2014-12-03,1264,854,208,188,20,24.36
2014-12-04,1169,866,232,216,16,26.79
2014-12-05,1337,890,188,173,15,21.12
2014-12-06,1298,852,201,183,18,23.59
2014-12-07,1436,984,198,184,14,20.12
2014-12-08,1464,1023,243,233,10,23.75
2014-12-09,1316,934,226,209,17,24.2
2014-12-10,1259,881,197,174,23,22.36
2014-12-11,1270,901,209,191,18,23.2
2014-12-12,1392,1008,253,238,15,25.1
2014-12-13,1427,993,220,199,21,22.16
2014-12-14,1384,971,192,178,14,19.77
2014-12-15,1450,1053,263,247,16,24.98
2014-12-16,1292,880,220,199,21,25
2014-12-17,1267,861,232,216,16,26.95
2014-12-18,1162,757,203,193,10,26.82
2014-12-19,1329,915,250,226,24,27.32
2014-12-20,1321,900,197,179,18,21.89
2014-12-21,1287,854,174,164,10,20.37
2014-12-22,1321,970,230,221,9,23.71
2014-12-23,1193,874,187,178,9,21.4
2014-12-24,1183,852,214,199,15,25.12
2014-12-25,1126,779,206,190,16,26.44
2014-12-26,1438,1046,257,242,15,24.57
2014-12-27,1453,1081,302,285,17,27.94
2014-12-28,1134,799,193,184,9,24.16
2014-12-29,1478,1083,255,238,17,23.55
2014-12-30,1326,945,261,240,21,27.62
2014-12-31,1195,885,222,215,7,25.08
2015-01-01,1350,887,218,195,23,24.58
2015-01-02,1385,975,271,251,20,27.79
2015-01-03,1238,836,210,200,10,25.12
2015-01-04,1233,869,186,170,16,21.4
2015-01-05,1378,907,216,205,11,23.81
2015-01-06,1275,891,229,218,11,25.7
2015-01-07,1282,881,215,207,8,24.4
2015-01-08,1265,880,211,198,13,23.98
2015-01-09,1254,863,210,196,14,24.33
2015-01-10,1385,939,241,232,9,25.67
2015-01-11,1291,915,190,180,10,20.77
2015-01-12,1404,958,223,207,16,23.28
2015-01-13,1130,775,216,195,21,27.87
2015-01-14,1193,843,198,190,8,23.49
2015-01-15,1351,962,251,237,14,26.09
2015-01-16,1307,899,233,220,13,25.92
2015-01-17,1363,931,198,185,13,21.27
2015-01-18,1359,926,183,170,13,19.76
2015-01-19,1397,987,253,240,13,25.63
2015-01-20,1242,854,200,181,19,23.42
2015-01-21,1159,865,227,210,17,26.24
2015-01-22,1257,886,224,206,18,25.28
2015-01-23,1346,975,280,269,11,28.72
2015-01-24,1393,999,238,225,13,23.82
2015-01-25,1527,1094,232,211,21,21.21
2015-01-26,1456,1083,272,259,13,25.12
2015-01-27,1421,973,236,226,10,24.25
2015-01-28,1196,833,231,219,12,27.73
2015-01-29,1359,989,257,248,9,25.99
2015-01-30,1379,952,242,232,10,25.42
2015-01-31,1516,1006,238,208,30,23.66
2015-02-01,1310,901,164,158,6,18.2
2015-02-02,1401,950,224,212,12,23.58
2015-02-03,1304,921,223,211,12,24.21
2015-02-04,1319,909,215,206,9,23.65
2015-02-05,1382,974,234,221,13,24.02
2015-02-06,1382,1008,241,232,9,23.91
2015-02-07,1400,995,190,177,13,19.1
2015-02-08,1446,961,156,149,7,16.23
2015-02-09,1550,1090,243,229,14,22.29
2015-02-10,1264,891,228,217,11,25.59
2015-02-11,1303,932,228,216,12,24.46
2015-02-12,1407,982,249,234,15,25.36
2015-02-13,1500,1024,268,250,18,26.17
2015-02-14,1407,944,228,213,15,24.15
2015-02-15,1545,1062,210,196,14,19.77
2015-02-16,1573,1119,253,240,13,22.61
2015-02-17,1357,950,226,214,12,23.79
2015-02-18,1352,959,227,210,17,23.67
2015-02-19,1417,977,241,225,16,24.67
2015-02-20,1400,953,238,221,17,24.97
2015-02-21,1456,978,236,222,14,24.13
2015-02-22,1447,958,180,165,15,18.79
2015-02-23,1438,985,257,242,15,26.09
2015-02-24,1249,890,276,262,14,31.01
2015-02-25,1213,876,206,194,12,23.52
2015-02-26,1271,845,236,218,18,27.93
2015-02-27,1323,936,248,230,18,26.5
2015-02-28,1418,965,218,200,18,22.59
2015-03-01,1310,927,191,182,9,20.6
2015-03-02,1284,904,225,213,12,24.89
2015-03-03,1252,909,243,224,19,26.73
2015-03-04,1250,881,224,211,13,25.43
2015-03-05,1281,940,228,212,16,24.26
2015-03-06,1308,914,228,219,9,24.95
2015-03-07,1352,890,207,192,15,23.26
2015-03-08,1463,995,206,195,11,20.7
2015-03-09,1423,954,218,207,11,22.85
2015-03-10,1213,817,208,198,10,25.46
2015-03-11,1373,935,207,201,6,22.14
2015-03-12,1385,989,220,208,12,22.24
2015-03-13,1389,975,253,247,6,25.95
2015-03-14,1421,953,218,205,13,22.88
2015-03-15,1535,1057,206,197,9,19.49
2015-03-16,1613,1111,244,224,20,21.96
2015-03-17,1339,938,221,207,14,23.56
2015-03-18,1372,986,235,222,13,23.83
2015-03-19,1272,892,226,211,15,25.34
2015-03-20,1378,933,267,247,20,28.62
2015-03-21,1528,1086,247,232,15,22.74
2015-03-22,1387,1003,210,196,14,20.94
2015-03-23,1623,1150,285,267,18,24.78
2015-03-24,1335,942,247,228,19,26.22
2015-03-25,1310,892,230,220,10,25.78
2015-03-26,1158,785,217,207,10,27.64
2015-03-27,1406,986,240,223,17,24.34
2015-03-28,1431,1008,226,213,13,22.42
2015-03-29,1343,984,224,212,12,22.76
2015-03-30,1576,1118,274,249,25,24.51
2015-03-31,1058,659,161,148,13,24.43
2015-04-01,1334,1027,300,281,19,29.21
2015-04-02,1405,1032,248,234,14,24.03
2015-04-03,1276,863,188,177,11,21.78
2015-04-04,1476,1145,303,291,12,26.46
2015-04-05,1378,995,201,192,9,20.2
2015-04-06,1350,966,209,199,10,21.64
2015-04-07,1509,1058,263,246,17,24.86
2015-04-08,1376,986,247,230,17,25.05
2015-04-09,1248,832,202,190,12,24.28
2015-04-10,1392,994,256,237,19,25.75
2015-04-11,1418,970,230,221,9,23.71
2015-04-12,1580,1061,194,178,16,18.28
2015-04-13,1464,1018,248,221,27,24.36
2015-04-14,1344,953,232,219,13,24.34
2015-04-15,1409,984,242,230,12,24.59
2015-04-16,1405,960,205,192,13,21.35
2015-04-17,1276,819,209,191,18,25.52
2015-04-18,1393,949,217,197,20,22.87
2015-04-19,1502,955,204,195,9,21.36
2015-04-20,1633,1140,253,234,19,22.19
2015-04-21,1400,970,225,209,16,23.2
2015-04-22,1423,979,231,215,16,23.6
2015-04-23,1410,986,210,199,11,21.3
2015-04-24,1253,914,254,242,12,27.79
2015-04-25,1477,1050,251,234,17,23.9
2015-04-26,1390,979,224,212,12,22.88
2015-04-27,1405,1007,252,231,21,25.02
2015-04-28,1238,874,217,207,10,24.83
2015-04-29,1132,779,214,206,8,27.47
2015-04-30,1314,937,164,152,12,17.5
2015-05-01,1232,875,141,129,12,16.11
2015-05-02,1418,984,211,194,17,21.44
2015-05-03,1256,884,135,125,10,15.27
2015-05-04,1502,1087,232,217,15,21.34
2015-05-05,1247,858,171,154,17,19.93
2015-05-06,1244,867,221,208,13,25.49
2015-05-07,1398,965,240,226,14,24.87
2015-05-08,1366,936,195,181,14,20.83
2015-05-09,1579,1117,246,229,17,22.02
2015-05-10,1514,1045,190,169,21,18.18
2015-05-11,1532,1073,257,237,20,23.95
2015-05-12,1340,897,222,211,11,24.75
2015-05-13,1432,984,233,206,27,23.68
2015-05-14,1492,1014,204,194,10,20.12
2015-05-15,1429,1015,264,251,13,26.01
2015-05-16,1402,941,207,190,17,22
2015-05-17,1514,996,212,201,11,21.29
2015-05-18,1566,1117,232,221,11,20.77
2015-05-19,1136,795,198,184,14,24.91
2015-05-20,1343,1000,222,207,15,22.2
2015-05-21,1307,909,190,175,15,20.9
2015-05-22,1279,893,241,215,26,26.99
2015-05-23,1381,887,189,174,15,21.31
2015-05-24,1554,1078,213,193,20,19.76
2015-05-25,1475,977,185,166,19,18.94
2015-05-26,1506,1062,229,213,16,21.56
2015-05-27,1348,949,253,236,17,26.66
2015-05-28,1492,1021,231,214,17,22.62
2015-05-29,1402,954,239,221,18,25.05
2015-05-30,1493,975,220,208,12,22.56
2015-05-31,1531,998,194,177,17,19.44
2015-06-01,1656,1182,262,239,23,22.17
2015-06-02,1362,956,244,221,23,25.52
2015-06-03,1369,914,187,179,8,20.46
2015-06-04,1439,986,246,228,18,24.95
2015-06-05,1422,998,250,234,16,25.05
2015-06-06,1631,1139,263,239,24,23.09
2015-06-07,1402,964,156,138,18,16.18
2015-06-08,1688,1120,259,243,16,23.12
2015-06-09,1450,995,237,215,22,23.82
2015-06-10,1413,949,217,195,22,22.87
2015-06-11,1456,990,191,183,8,19.29
2015-06-12,1480,1004,261,247,14,26
2015-06-13,1530,1023,228,210,18,22.29
2015-06-14,1654,1049,240,224,16,22.88
2015-06-15,1717,1185,229,215,14,19.32
2015-06-16,1448,988,228,208,20,23.08
2015-06-17,1446,1016,233,216,17,22.93
2015-06-18,1334,912,207,198,9,22.7
2015-06-19,1446,980,228,214,14,23.27
2015-06-20,1436,982,197,188,9,20.06
2015-06-21,1410,962,197,187,10,20.48
2015-06-22,1295,923,196,185,11,21.24
2015-06-23,1171,819,211,196,15,25.76
2015-06-24,1318,983,233,204,29,23.7
2015-06-25,1334,908,199,178,21,21.92
2015-06-26,1387,977,230,218,12,23.54
2015-06-27,1524,1051,236,211,25,22.45
2015-06-28,1536,1070,217,206,11,20.28
2015-06-29,1560,1124,269,257,12,23.93
2015-06-30,1326,959,218,202,16,22.73
2015-07-01,1348,991,257,243,14,25.93
2015-07-02,1403,1077,290,278,12,26.93
2015-07-03,1375,1000,263,241,22,26.3
2015-07-04,1570,1082,252,231,21,23.29
2015-07-05,1391,903,205,198,7,22.7
2015-07-06,1707,1138,296,275,21,26.01
2015-07-07,1549,1105,213,200,13,19.28
2015-07-08,1528,1067,228,213,15,21.37
2015-07-09,1480,1010,224,213,11,22.18
2015-07-10,1341,955,235,220,15,24.61
2015-07-11,1601,1152,225,212,13,19.53
2015-07-12,1441,1004,192,170,22,19.12
2015-07-13,1649,1119,249,240,9,22.25
2015-07-14,1495,1061,181,172,9,17.06
2015-07-15,1608,1141,256,231,25,22.44
2015-07-16,1382,1001,246,229,17,24.58
2015-07-17,1421,1030,264,249,15,25.63
2015-07-18,1587,1096,238,222,16,21.72
2015-07-19,1483,1002,167,148,19,16.67
2015-07-20,1540,1073,227,216,11,21.16
2015-07-21,1389,965,198,183,15,20.52
2015-07-22,1372,939,174,154,20,18.53
2015-07-23,1447,1052,234,217,17,22.24
2015-07-24,1392,944,217,204,13,22.99
2015-07-25,1369,977,197,187,10,20.16
2015-07-26,1358,965,191,177,14,19.79
2015-07-27,1428,1041,250,238,12,24.02
2015-07-28,1262,888,226,210,16,25.45
2015-07-29,1218,847,200,187,13,23.61
2015-07-30,1233,865,212,199,13,24.51
2015-07-31,1258,863,208,200,8,24.1
2015-08-01,1388,949,204,192,12,21.5
2015-08-02,1217,813,149,139,10,18.33
2015-08-03,1440,969,225,217,8,23.22
2015-08-04,1220,823,193,175,18,23.45
2015-08-05,1271,891,210,195,15,23.57
2015-08-06,1225,881,225,213,12,25.54
2015-08-07,1262,852,201,183,18,23.59
2015-08-08,1384,964,185,167,18,19.19
2015-08-09,1353,953,174,168,6,18.26
2015-08-10,1385,968,198,181,17,20.45
2015-08-11,1417,992,214,196,18,21.57
2015-08-12,1443,1014,226,206,20,22.29
2015-08-13,1316,921,209,196,13,22.69
2015-08-14,1244,885,200,187,13,22.6
2015-08-15,1347,898,158,147,11,17.59
2015-08-16,1253,899,185,167,18,20.58
2015-08-17,1352,959,236,220,16,24.61
2015-08-18,1267,852,201,187,14,23.59
2015-08-19,1186,820,209,197,12,25.49
2015-08-20,1215,847,221,201,20,26.09
2015-08-21,1271,879,227,208,19,25.82
2015-08-22,1322,915,195,176,19,21.31
2015-08-23,1256,874,184,176,8,21.05
2015-08-24,1256,883,207,195,12,23.44
2015-08-25,1227,822,226,206,20,27.49
2015-08-26,1308,906,202,184,18,22.3
2015-08-27,1295,919,212,194,18,23.07
2015-08-28,1274,937,226,213,13,24.12
2015-08-29,1428,971,214,202,12,22.04
2015-08-30,1541,1087,211,197,14,19.41
2015-08-31,1457,992,235,215,20,23.69
2015-09-01,1265,878,220,210,10,25.06
2015-09-02,1249,867,213,191,22,24.57
2015-09-03,1258,887,241,227,14,27.17
2015-09-04,1314,853,202,191,11,23.68
2015-09-05,1429,968,243,228,15,25.1
2015-09-06,1316,894,182,174,8,20.36
2015-09-07,1317,900,202,188,14,22.44
2015-09-08,1234,838,181,174,7,21.6
2015-09-09,1369,948,201,189,12,21.2
2015-09-10,1340,929,216,209,7,23.25
2015-09-11,1394,907,230,210,20,25.36
2015-09-12,1453,994,244,235,9,24.55
2015-09-13,1420,975,178,172,6,18.26
2015-09-14,1528,1080,242,228,14,22.41
2015-09-15,1328,922,230,214,16,24.95
2015-09-16,1312,915,227,212,15,24.81
2015-09-17,1270,912,232,216,16,25.44
2015-09-18,1337,933,231,217,14,24.76
2015-09-19,1445,963,191,183,8,19.83
2015-09-20,1467,1011,181,169,12,17.9
2015-09-21,1518,1050,250,236,14,23.81
2015-09-22,1285,850,205,189,16,24.12
2015-09-23,1310,919,204,193,11,22.2
2015-09-24,1353,926,204,194,10,22.03
2015-09-25,1327,914,229,207,22,25.05
2015-09-26,1457,991,221,211,10,22.3
2015-09-27,1483,1004,219,201,18,21.81
2015-09-28,1526,1059,262,244,18,24.74
2015-09-29,1321,911,219,208,11,24.04
2015-09-30,1400,959,199,187,12,20.75
2015-10-01,1391,969,216,202,14,22.29
2015-10-02,1441,977,250,239,11,25.59
2015-10-03,1580,1092,215,195,20,19.69
2015-10-04,1417,988,193,184,9,19.53
2015-10-05,1613,1143,240,228,12,21
2015-10-06,1453,983,237,228,9,24.11
2015-10-07,1371,940,227,206,21,24.15
2015-10-08,1387,973,213,199,14,21.89
2015-10-09,1439,954,214,202,12,22.43
2015-10-10,1483,991,223,203,20,22.5
2015-10-11,1514,1009,185,169,16,18.33
2015-10-12,1575,1304,227,216,11,17.41
2015-10-13,1344,1100,216,199,17,19.64
2015-10-14,1366,1110,218,207,11,19.64
2015-10-15,1356,1117,231,220,11,20.68
2015-10-16,1344,1090,213,206,7,19.54
2015-10-17,1327,1092,212,206,6,19.41
2015-10-18,1373,1169,185,168,17,15.83
2015-10-19,1486,1200,240,231,9,20
2015-10-20,1255,1037,223,216,7,21.5
2015-10-21,1289,1097,248,232,16,22.61
2015-10-22,1226,1028,230,214,16,22.37
2015-10-23,1310,1057,208,200,8,19.68
2015-10-24,1450,1206,223,211,12,18.49
2015-10-25,1452,1229,217,205,12,17.66
2015-10-26,1447,1187,258,235,23,21.74
2015-10-27,1181,995,203,191,12,20.4
2015-10-28,1348,1105,240,226,14,21.72
2015-10-29,1070,914,207,199,8,22.65
2015-10-30,1285,1074,215,203,12,20.02
2015-10-31,1323,1123,238,221,17,21.19
2015-11-01,1268,1064,215,203,12,20.21
2015-11-02,1363,1118,237,216,21,21.2
2015-11-03,1233,1002,206,193,13,20.56
2015-11-04,1344,1095,229,217,12,20.91
2015-11-05,1316,1076,220,207,13,20.45
2015-11-06,1340,1067,241,234,7,22.59
2015-11-07,1559,1218,204,182,22,16.75
2015-11-08,1605,1325,221,214,7,16.68
2015-11-09,1597,1294,260,234,26,20.09
2015-11-10,1422,1129,222,206,16,19.66
2015-11-11,1422,1160,198,184,14,17.07
2015-11-12,1547,1245,233,214,19,18.71
2015-11-13,1539,1270,235,227,8,18.5
2015-11-14,1482,1209,251,239,12,20.76
2015-11-15,1461,1192,190,176,14,15.94
2015-11-16,1588,1237,235,220,15,19
2015-11-17,1323,1087,219,200,19,20.15
2015-11-18,1378,1104,253,240,13,22.92
2015-11-19,1429,1178,223,216,7,18.93
2015-11-20,1372,1096,233,216,17,21.26
2015-11-21,1363,1112,221,208,13,19.87
2015-11-22,1346,1102,181,172,9,16.42
2015-11-23,1428,1200,227,212,15,18.92
2015-11-24,1215,954,190,179,11,19.92
2015-11-25,1266,1029,213,200,13,20.7
2015-11-26,1390,1124,219,209,10,19.48
2015-11-27,1328,1074,217,206,11,20.2
2015-11-28,1383,1122,215,206,9,19.16
2015-11-29,1331,1106,186,181,5,16.82
2015-11-30,1303,1099,232,217,15,21.11
